        00000000000000000000000000000000000000000000000000000000000000000000000000000000000000000000000000000
        00000000000000000000000000000000000000000000000000000000000000000000000000000000000000000000000000000
        00000000000000000000000000000000000000000000000000000000000000000000000000000000000000000000000000000
        00000000000000000000000000000000000000000000000000000000000000000000000000000000000000000000000000000
        00000000000000000000000000000000000000000000000000000000000000000000000000000000000000000000000000000
        00000000000000000000000000000000000000000000000000000000000000000000000000000000000000000000000000000
        00000000000000000000000000000000000000000000000000000000000000000000000000000000000000000000000000000
        00000000000000000000000000000000000000000000000000000000000000000000000000000000000000000000000000000
        00000000000000000000000000000000000000000000000000000000000000000000000000000000000000000000000000000
        00000000000000000000000000000000000000000000000000000000000000000000000000000000000000000000000000000
        00000000000000000000000000000000000000000000000000000000000000000000000000000000000000000000000000000
        00000000000000000000000000000000000000000000000000000000000000000000000000000000000000000000000000000
        00000000000000000000000000000000000000000000000000000000000000000000000000000000000000000000000000000
        00000000000000000000000000000000000000000000000000000000000000000000000000000000000000000000000000000
        00000000000000000000000000000000000000000000000000000000000000000000000000000000000000000000000000000
        00000000000000000000000000000000000000000000000000000000000000000000000000000000000000000000000000000
        00000000000000000000000000000000000000000000000000000000000000000000000000000000000000000000000000000
        00000000000000000000000000000000000000000000000000000000000000000000000000000000000000000000000000000
        00000000000000000000000000000000000000000000000000000000000000000000000000000000000000000000000000000
        00000000000000000000000000000000000000000000000000000000000000000000000000000000000000000000000000000
        00000000000000000000000000000000000000000000000000000000000000000000000000000000000000000000000000000
        00000000000000000000000000000000000000000000000000000000000000000000000000000000000000000000000000000
        00000000000000000000000000000000000000000000000000000000000000000000000000000000000000000000000000000
        00000000000000000000000000000000000000000000000000000000000000000000000000000000000000000000000000000
        00000000000000000000000000000000000000000000000000000000000000000000000000000000000000000000000000000
        00000000000000000000000000000000000000000000000000000000000000000000000000000000000000000000000000000
        00000000000000000000000000000000000000000000000000000000000000000000000000000000000000000000000000000
        00000000000000000000000000000000000000000000000000000000000000000000000000000000000000000000000000000
        00000000000000000000000000000000000000000000000000000000000000000000000000000000000000000000000000000
        00000000000000000000000000000000000000000000000000000000000000000000000000000000000000000000000000000
        00000000000000000000000000000000000000000000000000000000000000000000000000000000000000000000000000000
        00000000000000000000000000000000000000000000000000000000000000000000000000000000000000000000000000000
        00000000000000000000000000000000000000000000000000000000000000000000000000000000000000000000000000000
        00000000000000000000000000000000000000000000000000000000000000000000000000000000000000000000000000000
        00000000000000000000000000000000000000000000000000000000000000000000000000000000000000000000000000000
        00000000000000000000000000000000000000000000000000000000000000000000000000000000000000000000000000000
        00000000000000000000000000000000000000000000000000000000000000000000000000000000000000000000000000000
        00000000000000000000000000000000000000000000000000000000000000000000000000000000000000000000000000000
        00000000000000000000000000000000000000000000000000000000000000000000000000000000000000000000000000000
        00000000000000000000000000000000000000000000000000000000000000000000000000000000000000000000000000000
        00000000000000000000000000000000000000000000000000000000000000000000000000000000000000000000000000000
        00000000000000000000000000000000000000000000000000000000000000000000000000000000000000000000000000000
        00000000000000000000000000000000000000000000000000000000000000000000000000000000000000000000000000000
        00000000000000000000000000000000000000000000000000000000000000000000000000000000000000000000000000000
        00000000000000000000000000000000000000000000000000000000000000000000000000000000000000000000000000000
        00000000000000000000000000000000000000000000000000000000000000000000000000000000000000000000000000000
        00000000000000000000000000000000000000000000000000000000000000000000000000000000000000000000000000000
        00000000000000000000000000000000000000000000000000000000000000000000000000000000000000000000000000000
        00000000000000000000000000000000000000000000000000000000000000000000000000000000000000000000000000000
        00000000000000000000000000000000000000000000000000000000000000000000000000000000000000000000000000000
        00000000000000000000000000000000000000000000000000000000000000000000000000000000000000000000000000000
        00000000000000000000000000000000000000000000000000000000000000000000000000000000000000000000000000000
        00000000000000000000000000000000000000000000000000000000000000000000000000000000000000000000000000000
        00000000000000000000000000000000000000000000000000000000000000000000000000000000000000000000000000000
        00000000000000000000000000000000000000000000000000000000000000000000000000000000000000000000000000000
        00000000000000000000000000000000000000000000000000000000000000000000000000000000000000000000000000000
        00000000000000000000000000000000000000000000000000000000000000000000000000000000000000000000000000000
        00000000000000000000000000000000000000000000000000000000000000000000000000000000000000000000000000000
        00000000000000000000000000000000000000000000000000000000000000000000000000000000000000000000000000000
        00000000000000000000000000000000000000000000000000000000000000000000000000000000000000000000000000000
        00000000000000000000000000000000000000000000000000000000000000000000000000000000000000000000000000000
        00000000000000000000000000000000000000000000000000000000000000000000000000000000000000000000000000000
        00000000000000000000000000000000000000000000000000000000000000000000000000000000000000000000000000000
        00000000000000000000000000000000000000000000000000000000000000000000000000000000000000000000000000000
        00000000000000000000000000000000000000000000000000000000000000000000000000000000000000000000000000000
        00000000000000000000000000000000000000000000000000000000000000000000000000000000000000000000000000000
        00000000000000000000000000000000000000000000000000000000000000000000000000000000000000000000000000000
        00000000000000000000000000000000000000000000000000000000000000000000000000000000000000000000000000000
        00000000000000000000000000000000000000000000000000000000000000000000000000000000000000000000000000000
        00000000000000000000000000000000000000000000000000000000000000000000000000000000000000000000000000000
        00000000000000000000000000000000000000000000000000000000000000000000000000000000000000000000000000000
        00000000000000000000000000000000000000000000000000000000000000000000000000000000000000000000000000000
        00000000000000000000000000000000000000000000000000000000000000000000000000000000000000000000000000000
        00000000000000000000000000000000000000000000000000000000000000000000000000000000000000000000000000000
        00000000000000000000000000000000000000000000000000000000000000000000000000000000000000000000000000000
        00000000000000000000000000000000000000000000000000000000000000000000000000000000000000000000000000000
        00000000000000000000000000000000000000000000000000000000000000000000000000000000000000000000000000000
        00000000000000000000000000000000000000000000000000000000000000000000000000000000000000000000000000000
        00000000000000000000000000000000000000000000000000000000000000000000000000000000000000000000000000000
        00000000000000000000000000000000000000000000000000000000000000000000000000000000000000000000000000000
        00000000000000000000000000000000000000000000000000000000000000000000000000000000000000000000000000000
        00000000000000000000000000000000000000000000000000000000000000000000000000000000000000000000000000000
        00000000000000000000000000000000000000000000000000000000000000000000000000000000000000000000000000000
        00000000000000000000000000000000000000000000000000000000000000000000000000000000000000000000000000000
        00000000000000000000000000000000000000000000000000000000000000000000000000000000000000000000000000000
        00000000000000000000000000000000000000000000000000000000000000000000000000000000000000000000000000000
        00000000000000000000000000000000000000000000000000000000000000000000000000000000000000000000000000000
        00000000000000000000000000000000000000000000000000000000000000000000000000000000000000000000000000000
        00000000000000000000000000000000000000000000000000000000000000000000000000000000000000000000000000000
        00000000000000000000000000000000000000000000000000000000000000000000000000000000000000000000000000000
        00000000000000000000000000000000000000000000000000000000000000000000000000000000000000000000000000000
        00000000000000000000000000000000000000000000000000000000000000000000000000000000000000000000000000000
        00000000000000000000000000000000000000000000000000000000000000000000000000000000000000000000000000000
        00000000000000000000000000000000000000000000000000000000000000000000000000000000000000000000000000000
        00000000000000000000000000000000000000000000000000000000000000000000000000000000000000000000000000000
        00000000000000000000000000000000000000000000000000000000000000000000000000000000000000000000000000000
        00000000000000000000000000000000000000000000000000000000000000000000000000000000000000000000000000000
        00000000000000000000000000000000000000000000000000000000000000000000000000000000000000000000000000000
        00000000000000000000000000000000000000000000000000000000000000000000000000000000000000000000000000000
        00000000000000000000000000000000000000000000000000000000000000000000000000000000000000000000000000000
        00000000000000000000000000000000000000000000000000000000000000000000000000000000000000000000000000000
        00000000000000000000000000000000000000000000000000000000000000000000000000000000000000000000000000000
        00000000000000000000000000000000000000000000000000000000000000000000000000000000000000000000000000000
        00000000000000001000000000000000000000000000000000000000000000000000000000000000000000000000000000000
        00000000000000001000000000000000000000000000000000000000000000000000000000000000000000000000000000000
        00000000000000001000000000000000000000000000000000000000000000000000000000000000000000000000000000000
        00000000000000001000000000000000000000000000000000000000000000000000000000000000000000000000000000000
        00000000000000001000000000000000000000000000000000000000000000000000000000000000000000000000000000000
        00000000000000001000000000000000000000000000000000000000000000000000000000000000000000000000000000000
        00000000000000001000000000000000000000000000000000000000000000000000000000000000000000000000000000000
        00000000000000001000000000000000000000000000000000000000000000000000000000000000000000000000000000000
        00000000000000001000000000000000000000000000000000000000000000000000000000000000000000000000000000000
        00000000000000001111111111111111111111111111111111111000000000000000000000000000000000000000000000000
        00000000000000000000000000000000000000000000000000001000000000000000000000000000000000000000000000000
        00000000000000000000000000000000000000000000000000001000000000000000000000000000000000000000000000000
        00000000000000000000000000000000000000000000000000001000000000000000000000000000000000000000000000000
        00000000000000000000000000000000000000000000000000001000000000000000000000000000000000000000000000000
        00000000000000000000000000000000000000000000000000001000000000000000000000000000000000000000000000000
        00000000000000000000000000000000000000000000000000001000000000000000000000000000000000000000000000000
        00000000000000000000000000000000000000000000000000001000000000000000000000000000000000000000000000000
        00000000000000000000000000000000000000000000000000001000000000000000000000000000000000000000000000000
        00000000000000000000000000000000000000000000000000001000000000000000000000000000000000000000000000000
        00000000000000000000000000000000000000000000000000001000000000000000000000000000000000000000000000000
        00000000000000000000000000000000000000000000000000001000000000000000000000000000000000000000000000000
        00000000000000000000000000000000000000000000000000001000000000000000000000000000000000000000000000000
        00000000000000000000000000000000000000000000000000001000000000000000000000000000000000000000000000000
        00000000000000000000000000000000000000000000000000001000000000000000000000000000000000000000000000000
        00000000000000000000000000000000000000000000000000001000000000000000000000000000000000000000000000000
        00000000000000000000000000000000000000000000000000001000000000000000000000000000000000000000000000000
        00000000000000000000000000000000000000000000000000001000000000000000000000000000000000000000000000000
        00000000000000000000000000000000000000000000000000001000000000000000000000000000000000000000000000000
        00000000000000000000000000000000000000000000000000001000000000000000000000000000000000000000000000000
        00000000000000000000000000000000000000000000000000001000000000000000000000000000000000000000000000000
        00000000000000000000000000000000000000000000000000001000000000000000000000000000000000000000000000000
        00000000000000000000000000000000000000000000000000001000000000000000000000000000000000000000000000000
        00000000000000000000000000000000000000000000000000001000000000000000000000000000000000000000000000000
        00000000000000000000000000000000000000000000000000001000000000000000000000000000000000000000000000000
        00000000000000000000000000000000000000000000000000001000000000000000000000000000000000000000000000000
        00000000000000000000000000000000000000000000000000001000000000000000000000000000000000000000000000000
        00000000000000000000000000000000000000000000000000001000000000000000000000000000000000000000000000000
        00000000000000000000000000000000000000000000000000001000000000000000000000000000000000000000000000000
        00000000000000000000000000000000000000000000000000001000000000000000000000000000000000000000000000000
        00000000000000000000000000000000000000000000000000001000000000000000000000000000000000000000000000000
        00000000000000000000000000000000000000000000000000001000000000000000000000000000000000000000000000000
        00000000000000000000000000000000000000000000000000001000000000000000000000000000000000000000000000000
        00000000000000000000000000000000000000000000000000001000000000000000000000000000000000000000000000000
        00000000000000000000000000000000000000000000000000001000000000000000000000000000000000000000000000000
        00000000000000000000000000000000000000000000000000001000000000000000000000000000000000000000000000000
        00000000000000000000000000000000000000000000000000001000000000000000000000000000000000000000000000000
        00000000000000000000000000000000000000000000000000001000000000000000000000000000000000000000000000000
        00000000000000000000000000000000000000000000000000001000000000000000000000000000000000000000000000000
        00000000000000000000000000000000000000000000000000001000000000000000000000000000000000000000000000000
        11111111111111111111111111111111111111111111111111111000000000000000000000000000000000000000000000000
